R 1000 800

NO ./texture/wall_n.xpm

SO ./texture/wall_s.xpm

WE ./texture/wall_w.xpm

EA ./texture/wall_e.xpm

S ./texture/pillar.xpm

F 220,100,0

C 29,145,246


111111111111111111
1000000000000000011
1000001010100000111
10000011111000W00001
10000000000000002011
1010001000000012221
1011111000001111111
1010001110111110111
10010000001 0 11 1
11000 001010 0  1
1111111111111111
