R 300    300

NO ./texture/wall_1.xpm
SO ./texture/wall_2.xpm

WE ./texture/wall_3.xpm
EA ./texture/wall_4.xpm
S ./texture/item.xpm

C 75,  75,   175

F 50,50,50

11111111111111111
1000000000000001111
1002001010100011S111
10020011111011000211
100000000000000000 1
10100010020000222211
1011111000001111111
1010001110111110111
10010000001 0 11 1
11000 001010 0  1
1111111111111111